ΰ ---> ϋ
α ---> η
β ---> θ
γ ---> υ
δ ---> φ
ε ---> ω
ζ ---> β
η ---> κ
θ ---> ο
κ ---> μ
λ ---> ώ
μ ---> ρ
ν ---> ν
ξ ---> π
ο ---> σ
π ---> ζ
ρ ---> χ
ς ---> α
σ ---> ΰ
τ ---> ό
υ ---> ε
φ ---> ξ
χ ---> γ
ψ ---> τ
ω ---> ψ
ϋ ---> δ
ό ---> ς
ύ ---> ύ
ώ ---> λ
� ---> �
" " -> Έ
